111111 111111
11111P11111C1
100000100010
1011101000C01
1C10000001101
1000111100001
1010111100111
1010011C00001
10C1011111001
11110000C10E1
1111111111111
